2,3,2,1,0,2,2,3,3,3,2,3,2,2,2
3,3,0,0,0,2,0,3,4,3,0,2,0,0,2
3,4,3,3,3,2,0,3,4,3,0,3,2,0,2
3,4,4,4,3,0,0,3,4,4,3,4,3,2,3
3,4,4,4,4,3,3,4,4,4,4,4,3,0,0
3,4,4,4,4,4,4,4,4,4,4,4,4,3,0
3,4,4,4,4,4,4,4,4,4,4,4,4,3,0
3,4,4,4,4,4,4,4,4,4,4,4,4,3,0
3,4,4,4,4,4,4,4,4,4,4,4,4,3,0
3,4,4,4,4,4,4,4,4,4,4,4,4,3,0
3,4,4,4,4,4,4,4,4,4,4,4,4,3,0
3,3,4,4,4,4,4,4,4,4,4,4,4,3,0
2,0,3,4,4,4,4,4,4,4,4,4,4,4,2
3,2,3,3,3,3,4,4,4,4,4,4,4,4,3
1,0,0,0,0,0,2,3,3,3,3,3,3,3,2